************************************************
* ******************                         * *
O                    *********************** * *
* ****************** *                       * *
* *                * * ** **** *********** * * *
* * *** **** **** ** * ** ****         *** *   *
* *************** ** **** **** *** ** * ** *****
* *                    ** *    *** ** * ** * * *
* ****************** * ** * *** ** **   ** * ***
* *                * * ** *     ** **** ** * * *
**** *************** * ** ******** **** ** * * *
*                  * * *********** ******* * * *
* ** ************* * * **                * * * *
* ** *************** * *********** ******* *   *
* *                  * ****** ****     *** ** **
* ******************** **          ******* *  **
* *                  **** *** **** **   ** * ***
* ********** **********   *** *       **  ** ***
*                      ****** **** ***** *** ***
** ** ****** **************** **** *     *** ***
** *  *  *            ******* **********     ***
** * *** * ********** *******              *****
*  *     ***           *************************
************           ***************** *******
*                                             **
* ************       ******* *********** *******
* **        ***     ********      ******      **
* ***** *********  ********* **************** **
*                                        **** **
*****************  ************************** **
*   *************  *****************        * **
* *                               *** ** ** * **
* ***************  ************** *** ** ** * **
* *          ****  *           ** *** ** ** * **
*   *****      **  * ********* ** *** ** **   **
************** *   * *       * ** *** ** *******
*           ** **  * * ***** * ** *** **       *
**** ****** ** ** ** * **    * ** *** ** *******
**** ******    **  *   ** **** ** *** ** *******
*           ****** ****** ****    *** **       *
************************* *********** ** ***** *
                          ***         ******** *
 ************************ ************      ** *
       *******       ****          *** **** ** *
****** ******* ***** ************* *** ******* *
*              **     ***   *** ***         *  *
* ************ ** ***     **         * *** *****
*************************|**********************
