*************F************************************************I*
** ***            **            ***                           O*
** * **** ************** **                   ***** **** *******
** *    * *** *        *  ******* *****       *   *  *     *   *
** **   * *** *        *        * *    *     *    *  *     * ***
** ****** *** **********        * *     *   *     ****     *   *
**    *** *** *        *        *        * *                   *
** ****** *** ********************** ****   *        ********* *
** ****** ***                     *    *     *       *         *
**        ********** *** *** **** *   *       *    ***       ***
** ************    * *     * *    *   * * * * *      *      ****
**           **    * *  *  * *    *   ** * * **      *  *  *****
** ************    * *  *  * *    *                 **         *
** ************    * *  *  *  *   *   ***   ***    *           *
**          ***     *   *  *** *******   ***   ****     ***    *
** ************      *  *                         *         *  *
** ********************     *****     ** **       *  ****      *
**                     *   *******    *   *       *     ***    *
**    ****************  *   *****     *    ***    ***          *
**    * *   *        *   *        ****        *       **********
**    * *   **********         **              *  ***          *
**    * *                  ****    ***********  * *      *******
**    * *                      *                 **      *******
****************************************************************