****************************************************************
***************                                                *
**            *                 ***************************    *
** ********** *                 *                         *    *
** *        * *                 * ******************* *   *    *
** *        * *                 * *                 * *   *    *
** *        * *                 * *          ****** * *   *    *
** *        * *                 * *          *    * * *   *    *
** *        * *                 * *          *    * * *   *    *
** ********** ******************* ********* ****** ****** ******
IO                   *          *         *      *      *    * F
** ********** ******** ********** ********* ****** ****** **** *
** *        * *      * *        * *       * *           * *    *
** *        * ******** ********** ********* *           * *    *
** *        *                               *        **** **** *
** *        ********** **********************                * *
** *                 * **                  **  *******  * **** *
** ******************* *   **************   *  *     *  * *    *
**                              *********   *  *     *  *  *   *
************************   ****      ****   *  *     *  *   *  *
**       *     *       *   ********     *   *  *************** *
*******  *  *  *  *        **************   *        *   *     *
**          *     *    *                    *      *   *   *** *
****************************************************************