*I*F************************************************************
*O*           *        * *                    **  **************
* ******** ******        *              ******    **************
*  **                    ****      *    *   **    **************
** **  **************    *        * *    * * *    **************
*  **  *            *    *       *   *    *  *             *****
** **  *********  * *    *        * *        *             *****
*  **             * *    *     *   *         *    ***      *****
** **************** ******    * *       *    *   *   *     *****
** **                        *   *     * *   *  *     *    *****
*  ***************************  *       *    * *       *   *****
* ***  ********                *         ***** *********   *****
*      *      *               *                            *****
** ******** ***************** ***************** *********** ****
*                 *     *           *      **      *        ****
****   ******* ******************************** *********      *
**     *******    **                                         ***
** **                             **    *** *** * *            *
*  *************** ************ * **    * * *   ***       *   **
* ***  ********    *     *     *        *** *** * *  *****   ***
*      *           *                    * *   * * *        *****
** ******* ***************** ********** * * *** * * ******  ****
*                 *     *           *      **      *         ***
****************************************************************