****************************************************************
****************************************************************
*       *       *       *               *       *       *      *
* ******* ******* ******* ******* ******* ******* ******* ******
* ******* ******* ******* ******* ******* ******* ******* ******
*       *       *       *       *               *       *      *
* ******* ******* ******* ******* ******* ******* ******* ******
* ******* ******* ******* ******* ******* ******* ******* ******
*       *       *               *       *       *       *      *
* ******* ******* ******* ******* ******* ******* ******* ******
* ******* ******* ******* ******* ******* ******* ******* ******
*       *       *       *       *       *       *              *
* ******* ******* ******* ******* ******* ******* *******  *****
* ******* ******* ******* ******* ******* ******* ********  ****
*               *       *       *       *       *       ***  ***
* ******* ******* ******* ******* ******* ******* **********  **
* ******* ******* ******* ******* ******* ******* ***********  *
*       *       *       *       *       *               ****** *
* ******* ******* ******* ******* ******* ******* ***********  *
* ******* ******* ******* ******* ******* ******* **********  **
*       *               *       *       *       *       *    ***
* ********** ************** ******************************* ****
*     ******         ******                      ********** ****
*O*****************************************************     ****
*I*****************************************************F********