****************************************************************
*  *       *                                   **              *
*  *       *   ****                        ***                 *
****              *       ******        ***     ***********    *
*       ****      *****  *      *    ***  *    *************   *
*   *      *      *   * *        ****     *    *************   *
*        ******   *   **         *        *    *************   *
* *  *  *     *   *             *               ***********    *
*    *   **** *   *   **********          *                    *
**  *  *    * *   *   *                  *******************   *
*   * ******* *   *   *    *  ******     *                    **
*    *        *****   *    *             *   *******************
*     *               *    *             *   *******************
****  ******* ***** ***    *****         *   **               **
**          * *      ***   *   *       ***   **               **
*  *** ***  * *        *   *   *         *   **               **
* ** * * *  * *      * *** *   ***********   **               **
F ** * * *  * *      *                   *   **               **
**** * * *  * *      * **************    *   **               **
IO   *** **** ******** *****        **   *   **               **
****                                 **  *   **               **
*  *************************          ** *   **               **
*                          *           ***   *******************
****************************************************************