****************************************************************
***************                                                *
**            *                 ***************************    *
** ********** *                 *                         *    *
** *        * *                 * ******************* *   *    *
** *        * *                 * *                 * *   *    *
** *        * *                 * *          ****** * *   *    *
** *        * *                 * *          *    * * *   *    *
** *        * *                 * *          *    * * *   *    *
** ********** ******************* ********* ****** ****** ******
IO                   *          *         *      *      *    * F
** ********** ******** ********** ********* ****** ****** **** *
** *        * *      * *        * *       * *           * *    *
** *        * ******** ********** ********* *           * *    *
** *        *                               *        **** **** *
** *        ********** **********************                * *
** *                 * **                  **  *******  * **** *
** ******************* *                    *  *     *  * *    *
**                     *                    *  *     *  *  *   *
************************          *         *  *     *  *   *  *
**       *     *       *                    *  *************** *
*******  *  *  *  *                         *        *   *     *
**          *     *    *                           *   *   *** *
**          *******    *************     ***********   *   *** *
********         ***********************       **      ****    *
****************************************************************