******************I*F*******************************************
* **            **O*                            **             *
*    ********* *** * ****** ******************* ********  ** * *
* ********         * ****** *        *        * **    **  ** * *
****   *** ********* ****** *        *     **** **    **  ** * *
*      *** ********* ****** *        *          **    **  ** * *
* **         ******* ****** *        *     *******    **  ** * *
* ****************** ****** *        *     *******    **  ** * *
* ****************** *****************     *************  ** * *
*          ********* ******            *************      ** * *
*** ****** *****     ****** ********** *******      ******** * *
*** *****    ************** ********************************** *
*** *******                 *********                          *
*   *********************************  *****      ************ *
* ***********************************  *****      ************ *
* *****               ***************  *****               *** *
* ***********************************  *****      ************ *
*                      ***             *****      ************ *
* ******************** **************  *********************** *
* **            ****** **************  ****                    *
* *********          * ***********          ****************** *
* ******************** *************************************** *
*                                                              *
****************************************************************