****************************************************************
*                                                              *
IO                                                             *
*  **                                                          *
*                                                              *
*                                                              *
*                                                              *
*                                                              *
*                                                              *
*                                                              *
*                                                              *
*                                                              *
*                                                              *
*                                                              *
*                                                              *
*                                                              *
*                                                              *
*                                                              *
*                                                              *
*                                                              *
*                                                              *
*                                                              *
*                                                              *
**************************************************************F*