****************************************************************
*                                                              *
O                                                              *
*  **                                                          *
*                                                              *
*                                                              *
*                                                              *
*                                                              *
*                                                              *
*                                                              *
*                                                              *
*                                                              *
*                                                              *
*                                                              *
*                                                              *
*                                                              *
*                                                              *
*                                                              *
*                                                              *
*                                                              *
*                                                              *
*                                                              *
*                                                              *
**************************************************************|*
