*O**********************
* ******************   *
*                    ***
* ****************** ***
* *                * ***
* * *** **** **** ** ***
* *************** ** ***
* *                    *
* ****************** * *
* *                * * *
**** *************** * *
*                  * * *
* ** ************* * * *
* ** *************** * *
* *                  * *
* ******************** *
* *                  ***
* ********** ***********
*                      *
** ** ****** ***********
** *  *  *            **
** * *** * ********** **
*  *     ***           *
************|***********

